11111
101C1
1E101
100P1
11111
